border_size=1
usage=map

Xu, Xu, Xu, Xu, Xu, Xu, Xu, Xu, Xu, Xu, Xu, Xu, Xu, Xu, Xu, Xu, Xu, Xu, Xu, Xu, Xu, Xu, Xu, Xu, Xu, Xu, Xu, Xu, Xu, Xu, Xu, Xu, Xu, Xu, Xu, Xu, Xu, Xu, Xu, Xu, Xu, Xu, Xu
Xu, Xu, Xu, Xu, Xu, Xu, Xu, Xu, Xu, Xu, Xu, Xu, Xu, Xu, Xu, Xu, Xu, Xu, Xu, Xu, Xu, Xu, Xu, Xu, Xu, Xu, Xu, Xu, Xu, Xu, Xu, Xu, Xu, Xu, Xu, Xu, Xu, Xu, Xu, Xu, Xu, Xu, Xu
Xu, Xu, Xu, Xu, Xu, Xu, Xu, Xu, Xu, Xu, Xu, Xu, Xu, Xu, Xu, Xu, Xu, Xu, Xu, Xu, Xu, Xu, Xu, Xu, Xu, Xu, Xu, Xu, Xu, Xu, Xu, Xu, Xuc, Xu, Xuc, Xu, Xuc, Xu, Xuc, Xu, Xuc, Xu, Xu
Xu, Xu, Xu, Xu, Xu, Xu, Xu, Xu, Xu, Xu, Xu, Xu, Xu, Xu, Xu, Xu, Xu, Xu, Xu, Xu, Xu, Xu, Xu, Xu, Xu, Xu, Xu, Xu, Xu, Xu, Xu, Xu, Xuc, Xuc, Xuc, Xuc, Xuc, Xuc, Xuc, Xuc, Xuc, Xuc, Xuc
Qxu, Xu, Qxu, Xu, Qxu, Xu, Qxu, Xu, Qxu, Xu, Qxu, Xu, Qxu, Xu, Qxu, Xu, Qxu, Xu, Qxu, Xu, Xu, Xu, Xu, Xu, Qxu, Xu, Qxu, Xu, Qxu, Xu, Qxu, Xuc, Qxu, Xuc, Qxu, Xuc, Qxu, Xuc, Qxu, Xuc, Qxu, Xuc, Qxu
Qxu, Uu^Vud, Qxu^Bs\, Qxu, Qxu, Qxu, Qxu, Qxu, Qxu, Qxu, Uu, Qxu, Rr, Qxu, Uu, Qxu, Qxu, Qxu, Qxu, Qxu, Ww, Xu, Ww, Qxu, Qxu, Qxu, Qxu, Qxu, Uu, Qxu, Rr, Qxu, Uu, Qxu, Qxu, Qxu, Qxu, Qxu, Qxu, Qxu, Qxu^Bs/, Uu^Vud, Qxu
Qxu, Qxu, Qxu, Re, Qxu^Bs\, Qxu, Ww, Qxu, Qxu, Qxu, Qxu, Rr, Ur, Rr, Qxu, Qxu, Qxu, Qxu, Ww, Qxu, Ww, Ww, Ww, Qxu, Ww, Qxu, Qxu, Qxu, Qxu, Rr, Ur, Rr, Qxu, Qxu, Qxu, Qxu, Ww, Qxu, Qxu^Bs/, Re, Qxu, Qxu, Qxu
Qxu, Qxu, Qxu, Qxu, Qxu, Wwf, Ww, Ww, Ww, Qxu, Uu, Rr, Rr, Rr, Uu, Qxu, Ww, Ww, Ww, Ww, Ww, Ww, Ww, Ww, Ww, Ww, Ww, Qxu, Uu, Rr, Rr, Rr, Uu, Qxu, Ww, Ww, Ww, Wwf, Qxu, Qxu, Qxu, Qxu, Qxu
Qxu, Qxu, Xu, Qxu, Ww, Wwf, Wwf, Ww, Ww, Qxu, Wwf, Qxu, Wwf, Qxu, Wwf, Qxu, Ww, Ww, Gs, Ww, Ww, Ww, Ww, Ww, Gs^Fp, Ww, Ww, Qxu, Qxu, Qxu, Wwf, Qxu, Qxu, Qxu, Ww, Ww, Wwr, Ww, Ww, Qxu, Xu, Qxu, Qxu
Qxu, Qxu, Qxu, Qxu, Ww, Wwr, Gg, Ww, Ww, Ww, Wwf, Wwf, Ww^Vm, Wwf, Ww, Ww, Ww, Ww, Hh^Fp, Gg^Fp, Gg, Gg, Hh, Gg, Hh^Fp, Ww, Ww, Ww, Ww, Ww, Ww^Vm, Wwf, Wwf, Ww, Ww, Ww, Gg, Wwf, Wwf, Qxu, Qxu, Qxu, Qxu
Qxu, Qxu, Qxu, Ww, Ww, Ww, Ww, Hh, Hh^Vhh, Wwf, Ww, Ww, Ww, Wwf, Wwf, Ww, Gs^Fp, Hh^Fp, Hh^Vhh, Gg, Gg, Gg, Gg, Hh^Fp, Hh^Vhh, Hh^Fp, Gs^Fp, Ww, Ww, Ww, Ww, Ww, Ww, Wwf, Hh^Vhh, Hh, Ww, Ww, Ww, Ww, Qxu, Qxu, Qxu
Qxu, Qxu, Qxu, Ww, Ww, Ww, Wwr, Wwf, Mm, Hh, Ds, Ww, Ds, Ww, Ds, Gg, Gg, Gg, Hh^Fp, Gg, Gg, Gg, Gg^Fp, Ss, Hh^Fp, Hh^Fp, Gs^Fp, Gg, Ds, Ww, Ds, Ww, Ds, Hh, Mm, Wwr, Wwr, Ww, Ww, Ww, Qxu, Qxu, Qxu
Qxu, Ur, Qxu, Ww, Ww, Ww, Mm, Hh^Fp, Hh^Fp, Hh, Hh, Ds, Gg, Ds, Gg, Gg, Gg, Gs^Fp, Gg, Hh^Fp, Gg, Gg, Gg, Gs^Fp, Gg, Gs^Fp, Gg, Gg, Gg, Ds, Gg, Ds, Hh, Hh, Hh^Fp, Hh^Fp, Mm, Ww, Ww, Ww, Qxu, Ur, Qxu
Qxu, Qxu, Qxu, Qxu, Ww, Ww, Wwr, Ch, Ch, Mm, Rr, Gg, Gg, Gg, Gg, Gg, Ql, Gg, Gg, Gg, Gg, Gg, Gg, Gg, Gg, Gg, Ql, Gg, Gg, Gg, Gg, Gg, Rr, Mm, Ch, Ch, Wwr, Ww, Ww, Qxu, Qxu, Qxu, Qxu
Qxu, Ur, Qxu, Ww, Ww, Ww, Chw, Ch, Rr, Ch, Hh, Hh, Hh, Hh, Gg, Gg, Ql, Ql, Ql^Bs/, Gg, Ql, Ql, Ql, Gg, Ql^Bs\, Ql, Ql, Gg, Gg, Gg, Gg, Hh, Hh, Ch, Rr, Ch, Chw, Ww, Ww, Ww, Qxu, Ur, Qxu
Qxu, Qxu, Qxu, Ww, Ww, Mm^Vhh, Chw, 1 Kh, Rr, Rr, Hh, Hh, Gg, Gg^Vh, Gg, Ql, Ql, Re, Ql^Bs\, Ql, Ql, Qlf, Ql, Ql, Ql^Bs/, Re, Ql, Ql, Gg, Gg^Vh, Hh, Hh, Hh, Rr, Rr, 2 Kh, Chw, Mm^Vhh, Ww, Ww, Qxu, Qxu, Qxu
Qxu, Ur, Qxu, Ww, Ww, Ww, Wwr, Ch, Ch, Ch, Rr, Hh, Gg, Gg, Gg, Gg, Ql, Ql, Gg, Gg, Gg, Ql, Gg, Gg, Gg, Ql, Ql, Gg, Gg, Hh, Gg, Hh, Rr, Ch, Ch, Ch, Wwr, Ww, Ww, Ww, Qxua, Ur, Qxu
Qxu, Qxu, Qxu, Qxu, Ww, Ww, Mm, Ch, Hh^Fp, Mm, Hh, Gg, Gg, Gg, Gg, Gg, Gg, Gg, Gg, Gg, Gg, Gg, Gg, Gg, Gg, Gg, Gg, Gg, Gg, Gg, Gg, Gg, Hh, Mm, Hh^Fp, Ch, Mm, Ww, Ww, Qxu, Qxu, Qxu, Qxu
Qxu, Ur, Qxu, Ww, Ww, Ww, Wwr, Hh^Fp, Mm, Hh, Ds, Ds, Ds, Ds, Ds, Gg, Gs^Fp, Gs^Fp, Hh^Fp, Gs^Fp, Gg^Fp, Gg, Gg, Hh^Fp, Hh^Fp, Gs^Fp, Gg, Gg, Ds, Ds, Ds, Ds, Ds, Hh, Mm, Hh^Fp, Wwr, Ww, Ww, Ww, Qxu, Ur, Qxu
Qxu, Qxu, Qxu, Ww, Ww, Ww, Ww, Wwr, Hh^Vhh, Hh, Ww, Ww, Ww, Ww, Ww, Gg, Gs^Fp, Hh^Fp, Hh^Vhh, Ss, Gg, Gg, Gg, Gg, Hh^Vhh, Gg, Gs^Fp, Gg, Wwf, Ww, Ww, Ww, Ww, Hh, Hh^Vhh, Wwf, Ww, Ww, Ww, Ww, Qxu, Qxu, Qxu
Qxu, Qxu, Qxu, Ww, Wwf, Ww, Gg, Hh, Ww, Wwf, Wwf, Ww, Ww^Vm, Ww, Ww, Ww, Ww, Hh^Fp, Hh^Fp, Hh^Fp, Hh, Gg, Gg, Gg, Hh^Fp, Hh^Fp, Ww, Ww, Ww, Wwf, Ww^Vm, Ww, Wwf, Wwf, Ww, Hh, Gg, Ww, Ww, Ww, Qxu, Qxu, Qxu
Qxu, Qxu, Xu, Qxu, Ww, Wwf, Wwr, Ww, Ww, Ww, Qxu, Wwf, Wwf, Ww, Qxu, Ww, Ww, Ww, Gs^Fp, Gg, Ww, Gg, Ww, Gg^Fp, Gs, Ww, Ww, Ww, Wwf, Wwf, Wwf, Wwf, Wwf, Ww, Ww, Ww, Wwf, Wwr, Ww, Qxu, Xu, Qxu, Qxu
Qxu, Qxu, Qxu, Qxu, Qxu, Ww, Ww, Ww, Ww, Qxu, Uu, Qxu, Rr, Qxu, Uu, Qxu, Ww, Ww, Ww, Ww, Ww, Ww, Ww, Ww, Ww, Ww, Ww, Ww, Uu, Qxu, Rr, Qxu, Uu, Ww, Ww, Ww, Ww, Wwf, Qxu, Qxu, Qxu, Qxu, Qxu
Qxu, Qxu, Qxu, Qxu, Qxu^Bs/, Wwf, Ww, Ww, Qxu, Qxu, Qxu, Rr, Ur, Rr, Qxu, Qxu, Qxu, Ww, Ww, Ww, Ww, Ww, Ww, Ww, Ww, Ww, Qxu, Qxu, Qxu, Rr, Ur, Rr, Qxu, Qxu, Qxu, Ww, Ww, Wwf, Qxu^Bs\, Qxu, Qxu, Qxu, Qxu
Qxu, Qxu, Qxu^Bs/, Re, Qxu, Qxu, Qxu, Qxu, Qxu, Qxu, Uu, Rr, Rr, Rr, Uu, Qxu, Qxu, Qxu, Qxu, Qxu, Ww, Ww, Ww, Qxu, Qxu, Qxu, Qxu, Qxu, Uu, Rr, Rr, Rr, Uu, Qxu, Qxu, Qxu, Qxu, Qxu, Qxu, Re, Qxu^Bs\, Qxu, Qxu
Qxu, Uu^Vud, Qxu, Qxu, Qxu, Qxu, Qxu, Qxu, Qxu, Qxu, Qxu, Qxu, Qxu, Qxu, Qxu, Qxu, Qxu, Qxu, Qxu, Qxu, Xu, Xu, Xu, Qxu, Qxu, Qxu, Qxu, Qxu, Qxu, Qxu, Qxu, Qxu, Qxu, Qxu, Qxu, Qxu, Qxu, Qxu, Qxu, Qxu, Qxu, Uu^Vud, Qxu
Qxu, Qxu, Qxu, Qxu, Qxu, Qxu, Qxu, Qxu, Qxu, Qxu, Qxu, Qxu, Qxu, Qxu, Qxu, Qxu, Qxu, Qxu, Qxu, Qxu, Xu, Xu, Xu, Qxu, Qxu, Qxu, Qxu, Qxu, Qxu, Qxu, Qxu, Qxu, Qxu, Qxu, Qxu, Qxu, Qxu, Qxu, Qxu, Qxu, Qxu, Qxu, Qxu
